*** *******
*         *
* ******* *
*       * *
****** ** *
*         *
* ******* *
*   *   * *
* * * * * *
* *   *   *
********* *