*****************
                *
*               *
**************  *
*               *
*               *
*     ***********
*               *
*               *
*               *
*************** *