***********
*         *
*** * *   *
  * * *   *
* *** *** *
*     *   *
***** * ***
*     *   *
* ******* *
*         *
******* ***