*****************
                *
*               *
*               *
*               *
*               *
*               *
*               *
*      **********
*               *
*************** *