**********************************************************************************************
                                                                                             *
*                                                                                            *
*                                                                                            *
*                                                                                            *
*                                                                                            *
*                                                                                            *
*                                                                                            *
*                                                                                            *
*                                                                                            *
*                                                                                            *
*                                                                                            *
*                                                                                            *
*                                                                                            *
*                                                                                            *
*                                                                                            *
*                                                                                            *
*                                                                                            *
*                                                                                            *
*                                                                                            *
*                                                                                            *
*                                                                                            *
*                                                                                            *
*                                                                                            *
*                                                                                            *
*                                                                                            *
*                                                                                            *
*                                                                                            *
*                                                                                            *
*                                                                                            *
*                                                                                            *
*                                                                                            *
*                                                                                            *
*                                                                                            *
*                                                                                            *
*                                                                                            *
*                                                                                            *
*                                                                                            *
*                                                                                            *
*                                                                                            *
*                                                                                            *
*                                                                                            *
*                                                                                            *
*                                                                                            *
*                                                                                            *
*                                                                                            *
*                                                                                            *
*                                                                                            *
*                                                                                            *
*                                                                                            *
******************************************************************************************** *